11111111111111111111111111111111111111111111111111
11000000000000000000000000000000000000000000000011
11000000000000000000000000000000000000000000000011
11000000000000000000000000000000000000000006000011
1100030200000600000000200000600000000000300000p011
11000111111000000000011110090000000000001111111111
11000111111906660000000000011111000030000011111111
11060111111111111111000000000000001111100011111111
11006111111111111111444444444444444444444411111111
11600000000111111111111111111111111111111111111111
11000000000000000000000000000000000000000000000011
11000000000000000000000000000000000000000000000011
11000003000000000002000000000000000000020000000011
11111111111100000011100000200000000061111100000011
11111111111100666000000006660000000011111100000011
11111111111100090000090000000090000111111160000011
11111111111111111111111111111111111111111106000011
11000000000000000000000000000000000000000000600011
11006600010660010660010660010006600006600000060011
11000000019000019020010020019000009000009000600011
11001111111111111111111111111111111111111111111111
11000000000000000000000000000000000000000000000011
11000000000000000000666009000000000000000000000011
11100000000000001111111111110660000006660000000011
11110000000000011111111111110000111100000000000011
11111000666000111111111111110000000000011000000011
11111100000001111111111111114444444444411100000011
11111110000911111111111111114444444444411110002011
11111111111111111111111111111111111111111111000011
11000000000000000000000000000000000000000000060011
11000000000000000000000000000000000000000000060011
11000000000000000000106666010666600090006600011111
11000000000111113000100200010002001111100001111111
11000660001111111111111111111111111111111111111111
11000000011000000200000000000000000000000060000011
11000000311000000200000000000000000000000060000011
11066003110000011111000000000066600000660000000711
11002031110060111111130000000000000030001111111111
11000011110001111111113066003000011111100000000011
11300006600011111111111000111110000000000000000011
11111111111111111111111144444444444444444444444411
11111111111111111111111111111111111111111111111111

