11111111111111111111111111111111111111111111111111
11000000000000100000000000000000000000000000000011
11000000000000100000000000000000000000000000000011
11000000000000100000666000000000000000000000000011
11000000000000100011111110000000001110001110000011
11000000000000102000000010000000000000000000000011
110000010p0300100000000010000111144444444441000011
11444441111100190000000013110000144444444441000011
11111111000100111110000111110006111111111111300011
11111111000100111110200111111111111111111111300011
11000000000100000000001100000000000000000000000011
11001110000100000000011001111100090000011111111111
11000000000100600090110011111111111111111111111111
11001441000111111111100111111111111111111111111111
11001441100000000000001111111111111111111111111111
11001441111090000006001111111111111111111111111111
11031111111111111111111111111111111111111111111111
11000000000000000000000000000000000000000000000011
11111111100000000000600000600000000011110000000011
11111111111100001110001110001110001111111110000011
11111111111111000000000000000000111111111111000011
11111111111111444444444444444444111111111111000011
11111111111111111111111111111111111111111111300011
11000000000000000000000000000000000000000000000011
11000000000000000000000000000000000000000000000011
11705000000069000000000690000000000690000000001411
11111111111111111111111111111111111111111111111111



