11111111111111111111111111111111111111111111111111
10000000000000000000000000000000000000000000000011
10000000000000000000000000000000000000000000000011
10000000000000000000000000000000000000000000000011
10000000000000000000000000000000000000000000000011
10000000000000000000000000000000000000000000000011
10000000000000000000000000000000000000000000000011
10000000000000000000000000000000000000000000000011
10000000000000000000000000000000000000000000000011
10000000000000001100000000000000000000000000000011
10p00000001111000000000000000000000000000000000011
11111110000000000000000000000000000000000000000011
10000000000000000001110001111111110000000000000011
14444444444444444444444444444444110000000000000011
14444444444444444444444444444444110000000000000011
14444444444444444444444444444444110000000000000011
14444444444444444444444444444444110000000000000011
14444444444444444444444444444444110000000000000011
14444444444444444444444444444444110000000000b00711
11111111111111111111111111111111111111111111111111




